##############################################################################
                                                                #           ##
## ########## # # ########################### ################# # ######### ##
## #        # # #   #                       #             ##### # #      ## ##
## # ###### # # ### # # ################### ################### # # #### ## ##
## #      # # #     # # #                 #       ############# # # #### ## ##
## ######## # ####### # # ############### ####### #             # #    # ## ##
##          #      ## # # #    #                # ############# # # #### ## ##
################## ## # # ### ## ################ ####          # # #### ## ##
################## ## # #      # #                ############# # #    # ## ##
####            ## ## # # ###### # ############################ # # #### ## ##
#### ########## ## ## # ######## # #                            # #   ## ## ##
#### ########## ## ## #          # # ########################## # # # ## ## ##
#### ##      ## ## ## ########## # # #                        # # # # ## ## ##
#    ## #### ## ## ##          # # # # ###################### # # # # ## ## ##
# ## ## #### ## ## ########### # # # #                      # # # # # ## ## ##
# ## ## #### ## ##          ## # # # ######################## # # # # ## ## ##
# ## ## #### ## ########### ## # # #                          # # # # ## ## ##
# ## ##   ## ## #         # ## # # ############################ # # # ## ## ##
# ## #### ## ## # ####### # ## # #                              # # # ## ## ##
# ## #### ## ## # #       # ## # ## ### ######################### # # ## ## ##
# ## #### ## ## # # ####### ## # ## ### ######################### # # ## #  ##
# ## #### ## ## # #       # ## # ##                     #####     # # ## # ###
# ## #### ## ## # ####### # ## ############################## ##### # ## # ###
#         ## ## # #       # ##                            ###    ## # ## # ###
#### ####### ## # # ####### ############################# ### ## ## #  # # ###
#### ####### ## # # ##    #                             # ### ## ## #### # ###
#### ####### ## # # ## ## ############################# # ### ## ## #### # ###
#### ####### ## # #    ##                             # # ### ## ## #### # ###
#         ## ## # ##################################### # ### ## ##   ## # ###
#### #### ## ## #                                       # ### ## #### ## # ###
##        ## ## ######################################### ### ##    # ## # ###
#### #### ## ##                                           ### ####### ## # ###
#### #### ## ## #############################################       # ## # ###
#### #### ## ## ####### #####    ################################## # ## # ###
#### #### ## ##               ####                   ############## # ## #  ##
#         ## ########## #####    # ################# ##       ##### # ## ## ##
#### #### ## ##################### ####          ### ## ##### ##### # ## ## ##
#### #### ##                          # ######## ### ## #####       # ## ## ##
#         ######################## ## # ##       ### ## ############# ## ## ##
##############                   # ## # ## ######### ## ############# ## ## ##
#            # ################### ## # ## ######### ##               ## ## ##
# ########## # ######                 # ## ##        ################### ## ##
#          # #      # ################# ## ## ########################## ## ##
########## # ###### # #                 ## ##                            ## ##
         # #        # # # ################ ################### ############ ##
###### # # ########## # # ################                  ## ############ ##
#    # # #            # # ###           ########### ## ## # ##          ### ##
# #### # ############## # ############# #        ## ## ## # ############### ##
# #### #                # ############# # ######### ## ## #                 ##
#      ##################               #           ## ## ####################
##############################################################################
